NO ./path_to_the_north_texture
SO ./path_to_the_south_texture
WE ./path_to_the_west_texture
EA ./path_to_the_east_texture


F 255,255,255
C 0,0,0


11111111111
10000000001
10000000001
10000000001111
10000000000001
10000010001101
10001110001111
10000010001
100000000011
100000000001
111111111111
