NO 	./textures/sky.png
SO ./textures/south.png
EA ./textures/east.png
WE ./textures/west.png


F 255,50,50
C 80,80,80


1111111111111111111111111111111111111111111111111111111111111111
1000000000000000000000000000000000000000000000000000000000000001
1000000000000000000000000000000000000000000000000000000000000001
1000000000000000000010000000000000000000000000000000000000000001
1000000000000000000000000000000000000000110000000000000000000001
1000000000000000000000000000000000000000110000000000000000110001
1000000001110000000000000000001000000000000000100000000000110001
1000000001110000000000000000000000000000000000000000000000000001
1000000001110000000000000000000000000000000000000000000000000001
1000000000000000000000000000000000000000000000000000000000000001
1000000000000000010000000000000000000000000000000000000000000001
1000000000000000000000000000000000001000000000000000100000000001
1000000000000000000000000000000000000000000000000000000000000001
1000000000000000000000000000000000000000000000000000000000000001
1000011000000000000000000000000000000000000000000000000000000001
1000011000000000000000000000000011000000000000000000000000000001
1000000000000000000000000000000011000000000000000000000000000001
1000000000000000000000000000000000000000000000000000000000000001
1000000000000000000110000000000000000000000000000000001000000001
1000000000000000000110000000000000000000000000000000000000000001
1000000000000000000000000000000000000000000000000000000000000001
1000000000000000000000000000000000000000000000000000000000000N01
1000000000000000000000000000000000000000000000000000000000000001
1111111111111111111111111111111111111111111111111111111111111111