NO 	./textures/sky.png
SO ./textures/sky.png
EA ./textures/sky.png
WE ./textures/sky.png


F 255,200,80
C 0,0,0


11111111111
10000000001
10000000001
10000000001
10000000001
10000000001111
10000000000001
10000N10001101
10001110001111
10000010001
100000000011
100000000001
101111101111
10111110111
10000000001
10000000001
10000000001111
10000000000001
10000010001101
10001110001111
10000010001
100000000011
100000000001
111111111111