NO 	./textures/hand.png
SO ./textures/sky.png
EA ./textures/sky.png
WE ./textures/sky.png


F 255,200,80
C 0,0,0



11111111111
10000000001
10000000001
10000000001
10000000001
10000000001111
10000000000
10000N10001
10001110001
10000010001
10000000001
11111111111