NO 	./textures/stone.png
SO ./textures/cobblestone.png
EA ./textures/stone_bricks.png
WE ./textures/mossy_bricks.png

DO ./textures/door.png
EN ./textures/freaky.png

F 255,200,80
C 0,0,0


11111111111
1S0C000C001
10010001001
10011C11001
1C1100011C1
10000X00001
10000000001
10000000001
1000000000111111111111111111
1000000X00C00000000000000001
1000000000111111111111111111
10X00000001
10000000001
10000000001
10000000001
11111C11111
10000000001
10000000001
10000000001
10000000001
10001C10001
10001010001
10001110001
10000000001
10000000001
10000000001
10000000001
10000000001
11111111111