NO 	./textures/stone.png
SO ./textures/cobblestone.png
EA ./textures/stone_bricks.png
WE ./textures/mossy_bricks.png

F 255,200,80
C 0,0,0

11111111111111111
1X0001D0S0D1000X1
100001DD0DD100001
10100111011100101
1D100001C100001D1
1X1000000000001X1
11111111C11111111
10000000000000001
10000000000000001
10000000000000001
10000000000000001
10000000000000001
1DDDDDDDDDDDDDDD1
1DDDDDDDDDDDDDDD1
11111111111111111