NO 	./textures/stone.png
SO ./textures/cobblestone.png
EA ./textures/stone_bricks.png
WE ./textures/mossy_bricks.png

F 255,200,80
C 0,0,0

11111111111111111
10000100S00100001
10000100000100001
10100111011100101
10100001010000101
10100000000000101
11111111011111111
10000000000000001
10000000000000001
10000000000000001
10000000000000001
10000000000000001
10000000000000001
10000000000000001
11111111111111111