NO 	./textures/north.png
SO ./textures/south.png
EA ./textures/east.png
WE ./textures/west.png


F 255,200,80
C 0,0,0



11111111111
10010S01001
10010001001
10011C11001
1C1100011C1
10000000001
10000000001
10000000001
10000000001
10000000001
10000000001
11111111111