NO 	./textures/sky.png
SO ./textures/south.png
EA ./textures/east.png
WE ./textures/west.png


F 255,50,50
C 80,80,80


111111111111111111
100000000000000001
100000000000000101
100000000000000101
10000000N000000101
101010100010101101
100000000000000101
110101010101010101
100000000000000101
101010101010101101
100000000000000101
110101010101010101
100000000000000101
101010101010101101
100000000000000101
110101010101010001
111111111111111111