NO 	./textures/sky.png
SO ./textures/south.png
EA ./textures/east.png
WE ./textures/west.png


F 150,0,200
C 255,0,150


111111111111111
101100010001101
101001000100101
100001000100001
1000100N0010001
110111000111011
100001000100001
111011111110111
100100000000001
10010000000100111
10000000000000001
11111111111111101
11111111111111101
10000000000000001
10000011100000111
100000111000001
100000111000001
100000111000001
100000111000001
100000111000001
100001111100001
100111111111001
100111111111001
100111101111001
100011000110001
100000000000001
111111111111111