NO 	./textures/stone.png
SO ./textures/cobblestone.png
EA ./textures/stone_bricks.png
WE ./textures/mossy_bricks.png


DO ./textures/door.png


E0 ./textures/freaky.png
E1 ./textures/freaky.png
E2 ./textures/freaky.png


CO ./textures/collectible.png

F 255,50,50
C 80,80,255


1111111111111111111111111111111111111111111111111111111111111111
1000000000000000000000000000000000000000000000000000000000000001
10E0000000000000000000000000000000000000000000000000000000000001
1000000000000000000010000000000000000000000000000000000000000001
1000000000000000000000000000000000000000110000000000000000000001
1000000000D00000000000000000000000000000110000000000000000110001
1000000001C10000000000000000001000000000000000100000000000110001
10000000DCDCD000000000000000000000000000000000000000000000000001
1000000001C10000000000000000000000000000000000000000000000000001
1000000000D00000000000000000000000000000000000000000000000000001
1000000000000000010000000000000000000000000000000000000000000001
1000000000000000000000000000000000001000000000000000100000000001
1000000000000000000000000000000000000000000000000000000000000001
1000000000000000000000000000000000000000000000000000000000000001
1000011000000000000000000000000000000000000000000000000000000001
1000011000000000000000000000000011000000000000000000000000000001
1000000000000000000000000000000011000000000000000000000000000001
1000000000000000000DD0000000000000000000000000000000000000000001
100000000000000000D11D000000000000000000000000000000001000000001
100000000000000000D11D000000000000000000000000000000000000000001
1000000000000000000DD0000000000000000000000000000000000000000001
1000000000000000000000000000000000000000000000000000000000000001
10000000000000000000000000000000000000000000000000000000000000X1
1111111111111111111111111111111111111111111111111111111111111111