NO 	./textures/stone.png
SO ./textures/cobblestone.png
EA ./textures/stone_bricks.png
WE ./textures/mossy_bricks.png


DO ./textures/door.png


E0 ./textures/freaky.png
E1 ./textures/freaky.png
E2 ./textures/freaky.png


CO ./textures/collectible.png


F 255,200,80
C 0,0,0


1111111111111111111111111111
1X0001D0S0D1000XC00000000001
100001DD0DD10000111111111101
10100111011100101        101
1D100001C100001D1        101
1X1000000000001X1        101
11111111C11111111111111111C1111111
10000000000000001XXXXX000000XXXXX1
10000000000000001XXXXX000000XXXXX1
1000000000000000100000DDDDDD000001
1000000000000000C00000D0000D000001
1000000000000000100000DDDDDD000001
1DDDDDDDDDDDDDDD1XXXXX000000XXXXX1
1DDDDDDDDDDDDDDD1XXXXX000000XXXXX1
1111111C11111111111111111C11111111
      1D1       1D00000000000000D1
      1D1       1D0000000X000000D1
      1D111111111D000000XXX00000D1
      1DDDDDDDDDCD0000000X000000D1
      11111111111DDDDDDDDDDDDDDDD1
                111111111C11111111
                        101
                        111