NO 	./textures/north.png
SO ./textures/south.png
EA ./textures/east.png
WE ./textures/west.png


DO ./textures/door.png


E0 ./textures/freaky.png
E1 ./textures/freaky.png
E2 ./textures/freaky.png


CO ./textures/collectible.png


F 255,200,80
C 0,0,0


1111111111
1000000001
1010000C01
1000000001
1000000001
1000000001
1000000001
10X0000D01
10000N0001
1111111111